1 1 1 1 1 1 1 1 1 1 1 1 1 1 1 1 1 1 1 1 1 1 1 1 1 1 1 1 1 1 1 1 1 1 1 1 1 1 1 1 1 1 1 1 1 1 1 1 1 1
1 2 2 2 2 2 2 2 2 2 2 2 2 2 2 2 2 2 2 2 2 2 2 2 2 11 11 11 12 11 11 1 1 2 2 2 2 2 2 2 2 2 2 2 2 2 2 2 2 1
1 15 2 2 2 2 2 2 2 2 2 2 2 2 2 2 2 2 2 2 2 15 2 2 2 2 11 11 2 2 2 2 2 2 2 2 2 2 2 2 2 2 2 2 2 2 2 2 2 1
4 2 2 2 2 2 2 2 2 2 2 2 2 2 2 2 2 11 2 2 2 2 2 2 2 2 2 11 11 2 2 2 2 2 2 2 2 2 2 2 2 2 2 2 2 2 2 2 2 1
1 2 2 2 2 2 2 2 2 2 2 2 2 2 2 2 11 11 2 11 2 2 2 2 11 2 2 2 2 2 2 1 1 2 2 2 1 1 1 1 1 1 5 2 2 2 2 2 2 1
1 1 1 1 1 1 1 1 1 1 1 1 2 2 2 1 1 1 1 1 11 11 11 11 2 2 2 2 2 2 2 1 1 2 2 2 1 1 1 1 1 1 2 5 2 2 2 2 2 1
1 1 1 1 1 1 1 1 1 1 1 1 2 2 2 1 1 1 1 1 11 11 15 11 15 2 2 2 2 2 2 1 1 2 2 2 2 2 2 2 2 2 2 2 2 2 2 2 2 1
1 2 2 11 1 1 2 2 2 2 2 2 2 2 2 2 2 2 1 1 1 1 1 1 1 1 1 1 1 1 1 1 1 2 2 2 2 2 2 2 2 2 2 2 2 2 2 2 2 1
1 2 2 2 2 2 2 2 2 2 2 2 2 2 2 2 2 2 1 1 1 1 1 1 1 1 1 1 1 1 1 1 1 6 2 2 2 2 2 2 2 2 2 2 2 15 15 2 2 1
1 2 2 2 2 2 2 2 2 2 2 2 2 2 2 2 2 2 1 1 1 2 2 2 2 2 2 2 2 2 2 2 2 6 2 2 2 8 7 7 2 2 2 2 2 2 15 2 2 1
1 2 2 2 1 1 2 2 2 2 2 15 15 2 2 2 2 2 1 1 1 2 2 2 2 2 2 2 2 2 1 1 1 6 11 2 2 2 2 2 2 2 2 2 2 2 2 2 2 1
1 2 2 2 1 1 2 2 2 2 2 2 2 2 2 2 2 2 1 1 11 2 2 12 2 12 2 2 2 2 2 1 1 11 11 2 2 2 2 2 2 2 2 2 2 2 2 2 2 1
1 2 2 2 1 1 2 2 2 2 2 2 2 2 2 2 2 2 1 1 11 11 11 2 2 2 2 2 2 2 2 1 1 11 2 11 2 2 11 2 2 2 2 2 2 2 2 2 2 1
1 2 2 2 1 1 1 1 1 1 1 1 1 1 1 1 1 1 1 1 1 1 1 1 1 1 1 1 1 1 1 1 1 1 1 1 1 1 1 1 1 1 1 1 2 2 1 1 1 1
1 2 2 2 1 1 1 1 1 1 1 1 1 1 1 1 1 1 1 1 1 1 1 1 1 1 1 1 1 1 1 1 1 1 1 1 1 1 1 1 1 1 1 1 2 2 1 1 1 1
1 2 2 2 1 1 11 11 11 2 11 2 2 2 2 2 1 1 2 2 15 2 2 2 2 2 2 1 1 11 11 2 2 2 2 2 2 1 1 2 2 2 2 2 2 2 11 11 2 1
1 2 2 2 1 1 11 2 2 2 2 2 2 2 2 2 6 2 2 2 2 2 2 2 2 2 2 1 1 11 2 2 2 2 2 2 2 1 1 2 2 2 2 2 2 2 11 12 11 1
1 2 2 2 1 1 2 2 2 2 2 2 2 2 2 2 1 1 2 2 2 2 2 2 2 2 2 1 1 2 2 2 2 2 2 2 2 1 1 2 2 2 2 2 2 2 2 2 2 1
1 2 2 2 2 2 2 2 2 2 2 2 1 1 1 1 1 1 1 1 1 1 1 1 2 2 2 1 1 2 2 2 2 2 2 2 2 1 1 2 2 2 2 2 2 2 2 2 2 1
1 11 2 2 2 2 2 2 2 2 2 2 1 2 2 2 2 2 2 2 2 2 2 1 2 2 2 2 2 2 2 2 2 2 2 2 2 1 1 2 2 2 2 2 2 2 2 2 2 1
1 11 11 2 2 2 2 2 2 2 2 2 1 2 2 2 2 2 2 2 2 2 2 1 2 2 2 2 2 2 2 2 2 2 2 15 2 1 1 2 2 2 2 2 2 2 2 2 2 1
1 1 1 1 1 1 2 2 2 2 2 2 1 1 1 1 1 1 1 1 1 1 1 1 2 2 2 1 1 2 2 2 2 2 2 2 2 1 1 2 2 2 2 2 2 2 2 2 2 1
1 1 1 1 1 1 2 2 2 2 2 2 1 1 2 2 2 2 2 2 2 12 1 1 2 2 2 1 1 2 2 2 2 2 2 2 2 1 1 11 2 2 2 2 2 2 2 2 2 1
1 15 11 11 1 1 2 2 2 2 2 2 1 1 2 2 2 2 11 11 11 2 1 1 2 2 2 1 1 2 2 2 2 2 2 2 2 1 1 2 2 2 2 2 2 2 2 2 2 1
1 2 9 11 1 1 2 2 2 2 2 2 1 1 2 2 8 7 11 11 11 11 1 1 2 2 2 1 1 2 2 2 2 2 2 2 2 1 1 2 2 2 2 2 2 2 2 2 2 1
1 2 2 2 1 1 2 2 2 2 2 2 1 1 2 2 2 2 11 2 2 2 1 1 2 2 2 1 1 11 2 2 2 2 2 2 2 2 2 2 2 2 2 2 2 2 2 2 2 1
1 2 2 2 1 1 2 2 2 2 2 2 1 1 2 2 2 2 2 2 2 2 1 1 2 2 2 1 1 11 11 2 2 2 2 2 2 2 2 2 2 2 2 2 2 2 2 2 2 1
1 2 2 2 2 2 2 2 2 2 2 2 2 2 2 2 2 2 2 2 2 2 1 1 2 2 2 1 1 11 11 2 2 2 2 2 2 2 2 2 2 2 2 2 2 2 2 2 2 1
1 2 2 2 2 2 2 2 2 2 2 2 2 2 2 2 2 2 2 2 2 2 1 1 2 2 2 1 1 11 12 2 11 11 2 2 2 2 2 2 2 2 2 2 2 2 2 2 2 1
1 1 1 1 1 1 1 1 1 1 1 1 1 1 1 1 1 1 1 1 1 1 1 1 1 1 1 1 1 1 1 1 1 1 1 1 1 1 1 1 1 1 1 1 1 1 1 1 1 1
[
213 25 25
111 25 25
111 3 10