1 1 1 1 1 1 1 1 1 1 1 1 1 1 1 1 1 1 1 1 1 1 1 1 1 1 1 1 1 1 1 1 1 1 1 1 1 1 1 1 1 1 1 1 1 1 1 1 1 1
1 2 2 2 2 2 2 2 2 2 12 2 2 2 2 2 2 2 2 2 1 2 2 2 2 2 2 2 2 2 2 1 2 2 2 2 2 2 2 2 2 1 2 2 2 1 2 2 2 1
1 15 1 1 1 1 1 1 1 1 1 1 1 1 1 1 1 2 1 2 1 1 2 1 1 1 1 1 2 1 1 1 2 1 2 1 1 1 2 1 2 1 2 1 2 1 2 1 2 1
4 2 2 2 1 2 2 2 2 2 2 2 1 11 2 2 2 2 1 2 1 2 2 1 2 1 2 2 2 1 2 2 2 1 2 1 15 2 2 1 2 2 2 1 2 1 13 1 2 1
1 1 1 2 1 2 1 1 1 2 1 1 1 1 1 2 1 2 1 2 1 2 1 1 2 1 2 1 1 1 12 1 1 1 1 1 2 1 1 1 1 1 1 1 12 1 1 1 2 1
1 2 2 2 1 2 1 2 2 2 2 2 1 2 1 2 2 2 1 2 2 2 2 2 2 2 2 2 2 2 2 1 2 2 2 1 2 2 2 2 2 1 2 2 2 1 2 1 2 1
1 2 1 2 1 1 1 2 1 2 1 1 1 2 1 2 1 1 1 1 1 1 1 1 2 1 1 1 1 1 1 1 1 1 2 1 11 1 1 1 2 1 2 1 1 1 2 1 2 1
1 2 1 11 1 2 2 2 1 15 1 15 2 2 2 2 1 2 1 2 1 2 2 2 2 2 2 1 2 2 2 2 2 1 2 1 11 1 2 2 2 1 2 2 2 2 2 2 2 1
1 2 1 1 1 2 1 1 1 1 1 1 1 2 1 1 1 2 1 2 1 2 1 2 1 1 15 1 1 1 1 1 2 1 2 1 1 1 2 1 1 1 1 1 1 1 1 1 1 1
1 2 2 2 1 12 1 2 1 2 2 2 15 2 2 15 2 2 1 2 1 2 1 2 1 12 2 1 2 2 2 1 2 1 2 2 2 1 2 12 2 2 2 1 2 1 11 2 2 1
1 1 1 2 1 1 1 2 1 1 1 2 1 1 1 1 1 2 1 2 1 2 1 1 1 1 1 1 2 1 1 1 2 1 1 1 15 1 1 1 2 1 2 1 2 1 1 1 2 1
1 11 1 2 2 2 1 2 2 2 2 2 1 2 2 2 2 2 2 2 1 2 2 2 2 2 2 2 2 1 2 2 2 2 2 2 2 1 2 2 2 1 2 1 2 1 2 2 2 1
1 2 1 2 1 1 1 1 1 1 1 1 1 2 1 2 1 2 1 1 1 1 1 1 2 1 1 1 1 1 1 1 1 1 2 1 1 1 2 1 2 1 2 1 2 1 2 1 2 1
1 2 1 2 2 2 1 2 1 9 2 2 2 2 1 15 1 2 1 2 1 2 2 2 2 2 2 1 2 1 2 2 2 2 2 1 2 2 2 1 2 1 2 1 2 1 2 1 2 1
1 2 1 2 1 2 1 2 1 1 1 1 1 1 1 2 1 2 1 2 1 2 1 1 2 1 2 1 2 1 2 1 1 1 2 1 1 1 2 1 1 1 1 1 15 1 2 1 2 1
1 2 1 2 1 2 1 2 2 2 2 2 1 2 2 2 1 2 2 2 1 11 1 2 2 1 2 2 2 2 2 1 2 1 2 2 15 1 2 2 2 2 2 2 2 1 2 1 2 1
1 12 1 1 1 2 1 2 1 2 1 2 1 2 1 2 1 2 1 1 1 1 1 2 1 1 2 1 1 1 1 1 2 1 2 1 2 1 1 1 1 1 2 1 1 1 2 1 1 1
1 2 2 2 1 2 2 2 1 2 1 2 1 2 1 12 1 2 2 2 2 2 2 2 2 1 2 2 2 2 2 1 2 1 2 1 2 2 2 2 2 2 2 1 2 2 2 1 15 1
1 2 1 2 1 1 1 2 1 2 1 2 1 2 1 1 1 1 1 1 1 2 1 1 1 1 1 1 1 1 2 1 2 1 1 1 2 1 2 1 2 1 2 1 2 1 2 1 2 1
1 2 1 2 2 2 2 2 1 2 1 15 2 2 2 2 1 11 2 2 1 2 1 2 2 2 2 1 2 1 2 2 2 2 2 1 2 1 11 1 2 1 2 1 2 1 2 2 15 1
1 1 1 1 2 1 1 1 1 1 1 1 1 1 1 1 1 1 1 1 1 2 1 1 1 1 2 1 2 1 2 1 2 1 1 1 1 1 1 1 2 1 1 1 2 1 2 1 2 1
1 2 2 1 2 1 2 2 2 2 2 2 2 1 2 1 2 2 2 2 2 2 2 2 2 2 2 1 2 1 1 1 2 1 2 2 2 1 2 2 2 2 2 2 2 1 15 1 2 1
1 9 2 2 2 1 1 1 2 2 1 1 2 2 2 1 2 1 2 1 1 2 1 1 1 1 2 1 2 2 2 2 2 1 11 1 2 1 1 1 1 1 2 1 1 1 2 1 2 1
1 2 2 2 2 1 2 1 15 2 2 1 11 1 2 2 2 1 2 11 1 2 1 2 2 1 2 1 2 2 2 2 2 1 1 1 2 1 2 1 9 2 2 1 2 1 2 1 2 1
1 1 1 1 1 1 1 1 1 1 1 1 1 1 1 1 1 1 1 1 1 1 1 1 1 1 1 1 11 11 2 2 11 11 1 2 2 2 2 1 1 1 1 1 2 1 2 1 2 1
1 2 2 2 2 2 2 2 2 2 11 11 2 11 11 2 2 2 2 2 2 2 2 2 2 2 2 2 11 11 11 2 11 2 1 13 1 2 2 2 2 1 2 2 2 2 2 1 2 1
1 2 2 2 2 2 2 2 2 2 2 11 2 11 2 2 2 2 2 2 2 2 2 2 2 2 2 2 2 2 11 2 2 2 1 1 1 2 2 1 2 1 2 1 1 1 1 1 2 1
1 2 2 2 2 2 2 2 2 2 2 2 2 11 2 2 2 11 2 2 2 2 2 2 2 2 2 2 11 2 2 2 11 2 2 2 2 2 1 1 2 2 2 2 2 2 2 1 2 1
1 2 2 2 2 15 2 2 2 2 2 2 2 2 2 11 11 11 11 2 2 2 2 2 2 2 2 2 11 11 2 11 11 11 1 2 1 2 1 2 2 2 12 1 11 1 2 2 2 1
1 1 1 1 1 1 1 1 1 1 1 1 1 1 1 1 1 1 1 1 1 1 1 1 1 1 1 1 1 1 1 1 1 1 1 1 1 1 1 1 1 1 1 1 1 1 1 1 1 1
[
213 3 27