1 1 1 1 1 1 1 1 1 1 1 1 1 1 1 1 1 1 1 1 1 1 1 1 1 1 1 1 1 1 1 1 1 1 1 1 1 1 1 1 1 1 1 1 1 1 1 1 1 1
1 11 11 2 2 2 2 2 2 2 1 2 2 11 11 2 2 1 2 2 2 2 2 2 2 2 2 2 1 2 2 2 2 11 11 11 2 2 2 2 2 2 2 1 2 2 2 2 2 1
1 11 11 2 2 2 2 2 2 2 1 2 2 2 2 2 2 3 2 2 2 2 2 2 2 2 2 2 1 2 2 2 2 2 2 2 11 2 2 2 2 2 2 1 2 2 12 2 2 1
4 2 2 2 2 2 2 2 2 2 3 2 2 2 2 2 2 1 2 2 2 2 2 2 2 2 2 2 1 2 2 2 2 2 2 2 2 2 2 2 2 2 2 1 2 2 2 2 2 1
1 2 2 2 2 2 2 2 2 2 1 2 2 2 2 2 2 1 2 2 11 2 2 2 2 2 2 2 1 2 2 2 2 2 2 2 2 2 2 2 2 2 2 1 11 2 2 2 2 1
1 2 2 2 2 2 2 2 2 2 1 2 2 2 2 2 2 1 11 11 11 11 2 2 2 2 2 2 1 1 1 1 1 1 1 1 1 1 3 1 1 1 1 1 1 1 1 3 1 1
1 1 1 1 1 3 1 1 1 1 1 1 1 1 1 1 1 1 1 1 3 1 1 1 1 2 2 2 1 2 2 2 2 2 2 1 2 2 2 2 2 1 2 2 2 2 2 2 2 1
1 2 2 2 2 2 2 2 1 2 2 2 2 1 2 2 2 2 2 2 2 2 2 2 1 2 2 2 1 2 2 2 2 2 2 1 2 2 2 2 2 1 2 2 2 2 2 2 2 1
1 2 2 2 2 2 2 2 1 2 2 2 2 1 2 2 2 12 2 2 2 2 2 2 1 2 2 2 3 2 2 2 2 2 2 3 2 2 2 2 2 1 2 2 2 2 2 2 2 1
1 2 2 2 2 2 2 2 3 2 2 2 2 1 2 2 2 2 2 2 2 2 2 2 1 2 2 2 1 2 2 2 2 2 2 1 2 2 2 2 2 1 2 2 2 2 2 2 2 1
1 2 2 2 2 2 2 2 1 1 1 1 1 1 1 1 1 3 1 1 1 1 1 1 1 1 1 1 1 2 2 2 2 2 2 1 2 2 2 2 11 1 2 2 2 2 2 2 2 1
1 1 3 1 1 1 1 1 1 1 1 1 1 1 2 2 2 2 1 2 2 2 2 2 2 1 2 2 2 2 2 2 2 2 2 1 2 2 11 11 11 1 2 2 2 2 2 2 2 1
1 2 2 2 2 1 2 2 2 2 2 2 2 1 2 12 2 2 1 2 2 7 8 2 2 1 2 2 2 2 2 11 2 2 2 1 1 1 1 1 1 1 1 1 1 1 1 3 1 1
1 2 2 2 2 1 2 2 2 2 2 2 2 1 2 2 2 2 1 2 2 2 2 2 2 1 2 2 2 11 11 11 2 2 2 1 2 2 2 2 2 1 2 2 2 1 2 2 2 1
1 2 2 2 2 3 2 2 11 2 2 2 2 1 1 1 1 3 1 1 1 2 2 2 2 1 2 2 2 11 2 11 2 2 2 1 2 2 2 2 2 1 2 9 2 3 2 2 2 1
1 2 2 2 2 1 2 2 2 2 2 2 2 1 12 1 2 2 2 2 1 1 3 1 1 1 2 2 2 11 11 11 2 2 2 1 2 2 2 2 2 1 2 2 2 1 2 2 2 1
1 1 1 1 1 1 2 2 2 2 2 2 2 1 3 1 2 2 2 2 1 2 2 2 1 2 2 2 2 2 2 2 12 2 2 1 2 2 2 2 2 1 1 3 1 1 1 1 1 1
1 2 2 2 2 1 2 2 2 2 2 2 2 1 2 2 2 2 2 2 1 2 2 2 1 2 2 2 2 2 2 2 2 2 2 1 2 2 2 2 2 1 2 2 2 2 2 2 2 1
1 2 2 2 2 3 2 2 2 2 2 2 2 1 1 1 1 1 1 1 1 2 2 2 1 2 2 2 2 2 2 2 2 2 2 1 2 2 2 2 2 1 2 2 2 2 2 2 2 1
1 2 2 2 2 1 1 1 1 3 1 1 1 1 2 2 2 2 2 2 1 2 2 2 1 1 1 1 1 1 1 1 1 1 1 1 1 1 3 1 1 1 1 1 1 1 1 3 1 1
1 1 1 1 1 1 2 2 2 2 2 1 2 1 2 2 2 2 2 2 1 2 2 2 1 2 2 2 2 1 2 2 2 2 2 1 2 2 2 2 1 2 2 2 2 2 2 2 2 1
1 2 2 2 2 1 2 2 2 2 2 1 2 3 2 2 2 2 2 2 1 2 2 2 1 2 2 2 2 3 2 2 2 2 2 1 2 2 2 2 1 2 2 2 2 2 2 2 2 1
1 2 2 2 2 1 2 2 2 2 2 1 2 1 2 2 2 2 2 2 1 1 1 1 1 2 2 2 2 1 2 2 2 2 2 1 2 2 2 2 1 2 2 2 2 2 2 2 2 1
1 2 2 2 2 3 2 2 2 2 2 1 2 1 2 2 2 2 2 2 1 11 11 2 2 2 2 2 2 1 2 2 2 2 2 1 2 2 2 2 1 2 2 2 2 2 2 2 2 1
1 2 2 2 2 1 2 2 2 2 2 1 2 1 1 1 3 1 1 1 1 11 11 2 2 2 2 1 1 1 1 3 1 1 1 1 1 1 3 1 1 2 2 2 2 2 2 2 2 1
1 1 3 1 1 1 1 1 1 1 1 1 5 1 2 2 2 2 1 2 2 2 2 2 2 2 2 1 2 2 2 2 2 2 2 3 2 2 2 2 2 2 2 2 2 2 2 2 2 1
1 2 2 2 2 2 2 2 2 2 2 2 2 1 2 2 2 2 1 2 2 2 2 2 2 2 2 1 2 2 2 2 2 2 2 1 2 2 2 2 2 2 2 2 2 2 2 2 2 1
1 2 2 2 2 2 2 2 11 2 2 2 2 1 2 2 2 2 3 2 2 2 2 2 2 2 2 1 2 2 2 2 2 2 2 1 2 2 2 2 2 2 2 2 2 2 2 2 2 1
1 2 2 2 2 2 11 11 11 12 2 2 2 1 2 2 2 2 1 2 2 2 2 2 2 2 2 1 2 2 2 2 2 2 2 1 2 2 2 2 2 2 2 2 2 2 2 2 2 1
1 1 1 1 1 1 1 1 1 1 1 1 1 1 1 1 1 1 1 1 1 1 1 1 1 1 1 1 1 1 1 1 1 1 1 1 1 1 1 1 1 1 1 1 1 1 1 1 1 1
[
213 48 3